    00000000000000000000000000000000000000000000000000000000000000000000000000000000000000000000000000001111111111111111111111111111
    00000000001111111111222222222233333333334444444444555555555566666666667777777777888888888899999999990000000000000000000022222222
    01234567890123456789012345678901234567890123456789012345678901234567890123456789012345678901234567890123456789012345678901234567   
   
    00000000000000000000000000000000222222222222222233333333333333334444444444444444555555555555555566666666666666667777777777777777
    0123456789ABCDEF0123456789ABCDEF0123456789ABCDEF0123456789ABCDEF0123456789ABCDEF0123456789ABCDEF0123456789ABCDEF0123456789ABCDEF
-----------------------------------------------------------------------------------------------------------------------------------
000|00000000000000000000000000000000000000000000000000000000000000000000000000000000000000000000000000000000000000000000000000000000
001|00000000000000000000000000000000000000000000000000000000000000000000000000000000000000000000000000000000000000000000000000000000
002|00000000000000000000000000000000000000000000000000000000000000000000000000000000000000000000000000000000000000000000000000000000
003|00000000000000000000000000000000000000000000000000000000000000000000000000000000000000000000000000000000000000000000000000000000
004|00000000000000000000000000000000000000000000000000000000000000000000000000000000000000000000000000000000000000000000000000000000
005|00000000000000000000000000000000000000000000000000000000000000000000000000000000000000000000000000000000000000000000000000000000
006|00000000000000000000000000000000000000000000000000000000000000000000000000000000000000000000000000000000000000000000000000000000
007|00000000000000000000000000000000000000000000000000000000000000000000000000000000000000000000000000000000000000000000000000000000
008|00000000000000000000000000000000000000000000000000000000000000000000000000000000000000000000000000000000000000000000000000000000
009|00000000000000000000000000000000000000000000000000000000000000000000000000000000000000000000000000000000000000000000000000000000
00A|00000000000000000000000000000000000000000000000000000000000000000000000000000000000000000000000000000000000000000000000000000000
00B|00000000000000000000000000000000000000000000000000000000000000000000000000000000000000000000000000000000000000000000000000000000
00C|00000000000000000000000000000000000000000000000000000000000000000000000000000000000000000000000000000000000000000000000000000000
00D|00000000000000000000000000000000000000000000000000000000000000000000000000000000000000000000000000000000000000000000000000000000
00E|00000000000000000000000000000000000000000000000000000000000000000000000000000000000000000000000000000000000000000000000000000000
00F|00000000000000000000000000000000000000000000000000000000000000000000000000000000000000000000000000000000000000000000000000000000
010|00000000000000000000000000000000000000000000000000000000000000000000000000000000000000000000000000000000000000000000000000000000
011|00000000000000000000000000000000000000000000000000000000000000000000000000000000000000000000000000000000000000000000000000000000
012|00000000000000000000000000000000000000000000000000000000000000000000000000000000000000000000000000000000000000000000000000000000
013|00000000000000000000000000000000000000000000000000000000000000000000000000000000000000000000000000000000000000000000000000000000
014|00000000000000000000000000000000000000000000000000000000000000000000000000000000000000000000000000000000000000000000000000000000
015|00000000000000000000000000000000000000000000000000000000000000000000000000000000000000000000000000000000000000000000000000000000
016|00000000000000000000000000000000000000000000000000000000000000000000000000000000000000000000000000000000000000000000000000000000
017|00000000000000000000000000000000000000000000000000000000000000000000000000000000000000000000000000000000000000000000000000000000
018|00000000000000000000000000000000000000000000000000000000000000000000000000000000000000000000000000000000000000000000000000000000
019|00000000000000000000000000000000000000000000000000000000000000000000000000000000000000000000000000000000000000000000000000000000
01A|00000000000000000000000000000000000000000000000000000000000000000000000000000000000000000000000000000000000000000000000000000000
01B|00000000000000000000000000000000000000000000000000000000000000000000000000000000000000000000000000000000000000000000000000000000
01C|00000000000000000000000000000000000000000000000000000000000000000000000000000000000000000000000000000000000000000000000000000000
01D|00000000000000000000000000000000000000000000000000000000000000000000000000000000000000000000000000000000000000000000000000000000
01E|00000000000000000000000000000000000000000000000000000000000000000000000000000000000000000000000000000000000000000000000000000000
00F|00000000000000000000000000000000000000000000000000000000000000000000000000000000000000000000000000000000000000000000000000000000
020|00000000000000000000000000000000000000000000000000000000000000000000000000000000000000000000000000000000000000000000000000000000
021|00000000000000000000000000000000000000000000000000000000000000000000000000000000000000000000000000000000000000000000000000000000
022|00000000000000000000000000000000000000000000000000000000000000000000000000000000000000000000000000000000000000000000000000000000
023|00000000000000000000000000000000000000000000000000000000000000000000000000000000000000000000000000000000000000000000000000000000
024|00000000000000000000000000000000000000000000000000000000000000000000000000000000000000000000000000000000000000000000000000000000
025|00000000000000000000000000000000000000000000000000000000000000000000000000000000000000000000000000000000000000000000000000000000
026|00000000000000000000000000000000000000000000000000000000000000000000000000000000000000000000000000000000000000000000000000000000
027|00000000000000000000000000000000000000000000000000000000000000000000000000000000000000000000000000000000000000000000000000000000
028|00000000000000000000000000000000000000000000000000000000000000000000000000000000000000000000000000000000000000000000000000000000
029|00000000000000000000000000000000000000000000000000000000000000000000000000000000000000000000000000000000000000000000000000000000
02A|00000000000000000000000000000000000000000000000000000000000000000000000000000000000000000000000000000000000000000000000000000000
02B|00000000000000000000000000000000000000000000000000000000000000000000000000000000000000000000000000000000000000000000000000000000
02C|00000000000000000000000000000000000000000000000000000000000000000000000000000000000000000000000000000000000000000000000000000000
02D|00000000000000000000000000000000000000000000000000000000000000000000000000000000000000000000000000000000000000000000000000000000
02E|00000000000000000000000000000000000000000000000000000000000000000000000000000000000000000000000000000000000000000000000000000000
02F|00000000000000000000000000000000000000000000000000000000000000000000000000000000000000000000000000000000000000000000000000000000
030|00000000000000000000000000000000000000000000000000000000000000000000000000000000000000000000000000000000000000000000000000000000
031|00000000000000000000000000000000000000000000000000000000000000000000000000000000000000000000000000000000000000000000000000000000
032|00000000000000000000000000000000000000000000000000000000000000000000000000000000000000000000000000000000000000000000000000000000
033|00000000000000000000000000000000000000000000000000000000000000000000000000000000000000000000000000000000000000000000000000000000
034|00000000000000000000000000000000000000000000000000000000000000000000000000000000000000000000000000000000000000000000000000000000
035|00000000000000000000000000000000000000000000000000000000000000000000000000000000000000000000000000000000000000000000000000000000
036|00000000000000000000000000000000000000000000000000000000000000000000000000000000000000000000000000000000000000000000000000000000
037|00000000000000000000000000000000000000000000000000000000000000000000000000000000000000000000000000000000000000000000000000000000
038|00000000000000000000000000000000000000000000000000000000000000000000000000000000000000000000000000000000000000000000000000000000
039|00000000000000000000000000000000000000000000000000000000000000000000000000000000000000000000000000000000000000000000000000000000
03A|00000000000000000000000000000000000000000000000000000000000000000000000000000000000000000000000000000000000000000000000000000000
03B|00000000000000000000000000000000000000000000000000000000000000000000000000000000000000000000000000000000000000000000000000000000
03C|00000000000000000000000000000000000000000000000000000000000000000000000000000000000000000000000000000000000000000000000000000000
03D|00000000000000000000000000000000000000000000000000111111111111111111111111111111111110000000000000000000000000000000000000000000
03E|00000000000000000000000000000000000000000000000000000000000000000000000000000000000000000000000000000000000000000000000000000000
03F|00000000000000000000000000000000000000000000000000000000000000000000000000000000000000000000000000000000000000000000000000000000
040|11111111111111111111111111111111111111111111111111111111111111111111111111111111111111111111111111111111111111111111111111111111
041|22222222222222222222222222222222222222222222222222222222222222222222222222222222222222222222222222222222222222222222222222222222
042|22222222222222222222222222222222222222222222222222222222222222222222222222222222222222222222222222222222222222222222222222222222
043|22222222222222222222222222222222222222222222222222222222222222222222222222222222222222222222222222222222222222222222222222222222
044|22222222222222222222222222222222222222222222222222222222222222222222222222222222222222222222222222222222222222222222222222222222
045|22222222222222222222222222222222222222222222222222222222222222222222222222222222222222222222222222222222222222222222222222222222
046|22222222222222222222222222222222222222222222222222222222222222222222222222222222222222222222222222222222222222222222222222222222
047|22222222222222222222222222222222222222222222222222222222222222222222222222222222222222222222222222222222222222222222222222222222
048|22222222222222222222222222222222222222222222222222222222222222222222222222222222222222222222222222222222222222222222222222222222
049|22222222222222222222222222222222222222222222222222222222222222222222222222222222222222222222222222222222222222222222222222222222
04A|22222222222222222222222222222222222222222222222222222222222222222222222222222222222222222222222222222222222222222222222222222222
04B|22222222222222222222222222222222222222222222222222222222222222222222222222222222222222222222222222222222222222222222222222222222
04C|22222222222222222222222222222222222222222222222222222222222222222222222222222222222222222222222222222222222222222222222222222222
04D|22222222222222222222222222222222222222222222222222222222222222222222222222222222222222222222222222222222222222222222222222222222
04E|22222222222222222222222222222222222222222222222222222222222222222222222222222222222222222222222222222222222222222222222222222222
04F|22222222222222222222222222222222222222222222222222222222222222222222222222222222222222222222222222222222222222222222222222222222
050|22222222222222222222222222222222222222222222222222222222222222222222222222222222222222222222222222222222222222222222222222222222
051|22222222222222222222222222222222222222222222222222222222222222222222222222222222222222222222222222222222222222222222222222222222
052|22222222222222222222222222222222222222222222222222222222222222222222222222222222222222222222222222222222222222222222222222222222
053|22222222222222222222222222222222222222222222222222222222222222222222222222222222222222222222222222222222222222222222222222222222
054|22222222222222222222222222222222222222222222222222222222222222222222222222222222222222222222222222222222222222222222222222222222
055|22222222222222222222222222222222222222222222222222222222222222222222222222222222222222222222222222222222222222222222222222222222
056|22222222222222222222222222222222222222222222222222222222222222222222222222222222222222222222222222222222222222222222222222222222
057|22222222222222222222222222222222222222222222222222222222222222222222222222222222222222222222222222222222222222222222222222222222
058|22222222222222222222222222222222222222222222222222222222222222222222222222222222222222222222222222222222222222222222222222222222
059|22222222222222222222222222222222222222222222222222222222222222222222222222222222222222222222222222222222222222222222222222222222
05A|22222222222222222222222222222222222222222222222222222222222222222222222222222222222222222222222222222222222222222222222222222222
05B|22222222222222222222222222222222222222222222222222222222222222222222222222222222222222222222222222222222222222222222222222222222
05C|22222222222222222222222222222222222222222222222222222222222222222222222222222222222222222222222222222222222222222222222222222222
05D|22222222222222222222222222222222222222222222222222222222222222222222222222222222222222222222222222222222222222222222222222222222
05E|22222222222222222222222222222222222222222222222222222222222222222222222222222222222222222222222222222222222222222222222222222222
05F|22222222222222222222222222222222222222222222222222222222222222222222222222222222222222222222222222222222222222222222222222222222
060|22222222222222222222222222222222222222222222222222222222222222222222222222222222222222222222222222222222222222222222222222222222
061|22222222222222222222222222222222222222222222222222222222222222222222222222222222222222222222222222222222222222222222222222222222
062|22222222222222222222222222222222222222222222222222222222222222222222222222222222222222222222222222222222222222222222222222222222
063|22222222222222222222222222222222222222222222222222222222222222222222222222222222222222222222222222222222222222222222222222222222
064|22222222222222222222222222222222222222222222222222222222222222222222222222222222222222222222222222222222222222222222222222222222
065|22222222222222222222222222222222222222222222222222222222222222222222222222222222222222222222222222222222222222222222222222222222
066|22222222222222222222222222222222222222222222222222222222222222222222222222222222222222222222222222222222222222222222222222222222
067|22222222222222222222222222222222222222222222222222222222222222222222222222222222222222222222222222222222222222222222222222222222
068|22222222222222222222222222222222222222222222222222222222222222222222222222222222222222222222222222222222222222222222222222222222
069|22222222222222222222222222222222222222222222222222222222222222222222222222222222222222222222222222222222222222222222222222222222
06A|22222222222222222222222222222222222222222222222222222222222222222222222222222222222222222222222222222222222222222222222222222222
06B|22222222222222222222222222222222222222222222222222222222222222222222222222222222222222222222222222222222222222222222222222222222
06C|22222222222222222222222222222222222222222222222222222222222222222222222222222222222222222222222222222222222222222222222222222222
06D|22222222222222222222222222222222222222222222222222222222222222222222222222222222222222222222222222222222222222222222222222222222
06E|22222222222222222222222222222222222222222222222222222222222222222222222222222222222222222222222222222222222222222222222222222222
06F|22222222222222222222222222222222222222222222222222222222222222222222222222222222222222222222222222222222222222222222222222222222
070|22222222222222222222222222222222222222222222222222222222222222222222222222222222222222222222222222222222222222222222222222222222
071|22222222222222222222222222222222222222222222222222222222222222222222222222222222222222222222222222222222222222222222222222222222
072|22222222222222222222222222222222222222222222222222222222222222222222222222222222222222222222222222222222222222222222222222222222
073|22222222222222222222222222222222222222222222222222222222222222222222222222222222222222222222222222222222222222222222222222222222
074|22222222222222222222222222222222222222222222222222222222222222222222222222222222222222222222222222222222222222222222222222222222
075|22222222222222222222222222222222222222222222222222222222222222222222222222222222222222222222222222222222222222222222222222222222
076|22222222222222222222222222222222222222222222222222222222222222222222222222222222222222222222222222222222222222222222222222222222
077|22222222222222222222222222222222222222222222222222222222222222222222222222222222222222222222222222222222222222222222222222222222
078|22222222222222222222222222222222222222222222222222222222222222222222222222222222222222222222222222222222222222222222222222222222
079|22222222222222222222222222222222222222222222222222222222222222222222222222222222222222222222222222222222222222222222222222222222
07A|22222222222222222222222222222222222222222222222222222222222222222222222222222222222222222222222222222222222222222222222222222222
07B|22222222222222222222222222222222222222222222222222222222222222222222222222222222222222222222222222222222222222222222222222222222
07C|22222222222222222222222222222222222222222222222222222222222222222222222222222222222222222222222222222222222222222222222222222222
07D|22222222222222222222222222222222222222222222222222222222222222222222222222222222222222222222222222222222222222222222222222222222
07E|22222222222222222222222222222222222222222222222222222222222222222222222222222222222222222222222222222222222222222222222222222222
07F|22222222222222222222222222222222222222222222222222222222222222222222222222222222222222222222222222222222222222222222222222222222
